NO texture/wood.xpm
SO texture/wood.xpm
WE texture/wood.xpm
EA texture/wood.xpm

F 220,100,0
C 225,30,0

1111111
 100101
 101001
 1100N1
 111111