NO texture/greystone.xpm
SO texture/redbrick.xpm
WE texture/purplestone.xpm
EA texture/bluestone.xpm

F 139,69,19
C 0,0,0

11111
10S01
10001
11221
10001
11111