NO texture/wood.xpm
SO texture/wood.xpm
WE texture/wood.xpm
EA texture/wood.xpm

F 220,100,0
C 225,30,0

11111
10101
11N11
101S1
11111