NO texture/pillar.xpm
SO texture/pillar.xpm
WE texture/pillar.xpm
EA texture/pillar.xpm

F 220,100,0
C 225,30

11111
10101
11N11
10101
11111